111111111111111
101C0000C0000C1
100000C00000001
1111111E1111111
1000000C0000001
1000C0000C0P0C1
100000000000001
111111111111111
