1111111
1000011
1P0C1E1
1000011
1111111
