11111111
10000001
1P0C10E1
10001011
11111111
