111111111
100011001
1P0C110E1
100011011
111111111
