111111
1PCE11
111101
100011
111111
