11111
1P011
10001
10001
11011
11011
11011
10011
10001
10001
11011
11011
11011
1C011
10E01
11111
