111011111111
1000P0000001
1C0000000001
100000000001
1000000000E1
111111111111
